11101000
00000010
11100010
00011110
00010010
01010010
01011010
00010000
10110110
00010000
11001001
00000100