00000100
11001001
00010000
10110110
00010000
01011010
01010010
00010010
00011110
11100010
00000010
11101000