00100000
10010011
00001000
01101101
00001000
01011010
01001010
01001000
01111000
01000111
01000000
00010111